00000000000000000000
00000000000000000000
00000000000000000000
00000000000000000000
00000000000000000000
00000111100000000000
0000011d111100000000
0000111111l110000000
0000l111111111000000
0000ggggggggggg00000
0g001111111111100000
00001111111111100000
000011111111l1100000
0l001111111111100000
00000111p11111000000
00000011111110000000
00000001111000000000
00000000000000000000
00000000000000000000
00000000000000000000
