00000000000000000000
00000000000000000000
00000000000000000000
00000000000000000000
00000000000000000000
00111111111111110000
00rp1111111111110000
00111111111111110000
00l11111100011110000
00111111000001110000
0011111100000bbb0000
0011111r00l001110000
00111111011101110l00
00011111011101110000
0000111101110bbb0000
00000111r1b101110000
00000011011101d10000
00000001011101110000
00000000000000000000
00000000000000000000
