00l00000000000000000
00000000000000000000
00000000000000000000
011111b0l00000000000
01p111b0000000000000
0111111000e00r000000
0bbb1011100000000000
0sss0001100000000000
00l1s111110000e0t000
0n100001110000000000
00000000011000000000
0000000011111l000000
00n10001111110000000
00000000sss100000000
0n10000bb0110000n100
00000sbbb01000000000
00ad1sbb000000000000
000000l00r00000n1000
00000000000000000000
0000000000000000b000
