00000000000000000000
00000000000000000000
00000000000000000000
00000000000000000000
00000000000001110000
00000000000001d10000
00000000000001110000
00000000000001110l00
00000000000001110000
00011111111111110000
00011111111111110e00
00011111111111110000
00011100000000000000
00011100l00000000000
00011100000000000000
00011100000000000000
0001p100e00000000000
00011100000000000000
00000000000000000000
00000000000000000000
