00000000000000000000
00000000000000000000
00000000000b00000000
00r00000t00b0t000000
00000000000b00000000
00t00l01110s00000000
00000011p11110000000
0000011110011l000000
0001bbbb000110000000
00010001000ss0000000
00010001000000000000
00000001000000000000
00001001000000000000
00001l01001d00000000
000b10011110r0000000
00001001001000000000
00001001000000000000
r0000001000000000000
t0000000000l00000000
00000000000000000000
