00000000000000000000
0t000p11000000000000
00001n11l000000r0000
00001011000000000000
00001110110000000000
00000011110000et0000
0r00e0s1111100000000
00000000111100000000
0000000bbb0ss1b00000
000000000111010l0000
00000l00110bb1000000
00000000011111000000
000000000ss000000000
00000000011000000000
00000000001d00000000
00000000000000000000
00000000000000000000
0000000000l000000000
00000000000000000000
00000000000000000000
