00000000000000000000
00000000000000000000
00000000000000000000
00000000000000000000
00000001111100000000
000000011d1100000000
000000L11111L0000000
00000001111100000000
00000001111100000000
00000001111100000000
00000001111100000000
00000001111100000000
000000L11111L0000000
000000011p1100000000
00000001111100000000
00000000000000000000
00000000000000000000
00000000000000000000
00000000000000000000
00000000000000000000
