00000000000000000000
00000000000000000000
00000000000000000000
00000000000000000000
00000000000000000000
00000000000000000000
00000000000000000000
00000000000000000000
000000t000000t000000
00000000l00000000000
00000000000000000000
00001111111000000000
0001p111111111b00000
00000000001111bbbl00
0000r0l000000001b000
00000000000000011000
0000000000000001d000
000000b000000r000000
00000000000000000000
00000000000000000000
