00000000000000000000
0l00e000000000000000
00000100000000000000
01s1b1000n10t000a0r0
bbbb0b0000n1n0000000
000bnb000000l0000000
00000111s11000000000
00e00111s11100000000
00001111s01110000000
00011000000111100000
00011l0000011110b000
0011000000000111bl00
00110000000001bbb000
00p10000000000b01000
00100000000000bssss0
00000000000000001100
00000t00000000001000
0000000000000000d000
0t000e00000000000000
0000000000000000l000
