00000000000000000000
00000000000000000000
00000000000000000000
00000000000000000000
00000000000000000000
0000bs00000000000000
000lbs00eeeen0000000
000000t0000000000000
0000000r000000000000
00011111111111111100
000p111111111111110d
00011111111111111100
00000000000000000000
0000l000l000l000l000
00000000r00000000000
0000r000t000r000t000
00000000000000000000
000rt000000000000000
00000000000000000000
00000000000000000000
