00000000000000000000
00000000e000000r0000
00000000000000000000
00000000111100000000
00011111111110000000
0t0lsssb1111p1000000
0001111b111111000000
00d11n1b011111100000
000n111b0111l1100000
0001111b111111100000
00001b1b111111100000
0001sssb111100000000
0e001111111110000000
00001111111110000e00
0000s111110000000000
00000000000000000000
00000000000000000000
00000000l000000t0000
00000000000000000000
00000000000000000000
