00000000000000000000
00000000000000000000
0000r00t000000000000
00000000000000000000
00011n00000000000l00
00000000s10000000000
0000b0l1111b00000000
0000000n11sb11d00000
00e00011sssb01100000
00000111111100000000
0000011111ss00000000
0000011111a0l0e00000
00l000b011ss00000000
000000b0111000000000
00000011101000000000
000000000p1000000000
00000000000000000000
000000000r0l000s0000
00000000n100000s0000
000000000e00000s0r00
