00000000000000000000
00000000000000000000
00000000000000000000
00000000000000000000
00000000000000000000
0000L000000000000000
00000000000000000000
00000000000000000000
00011111r1111l111000
00011111111111111000
0001p1111111111d1000
00011111111111111000
00011111111111111000
00000000l00000000000
00000000000000000000
00000000000000000000
00000000000000000000
00000000000000000000
00000000000000000000
00000000000000000000
