00000000000000000000
0l0tsb00000000000000
00000000000000000000
00001000000000000000
00s11000le0100000000
00011010000110000000
00001110010111110000
00011111111111p10000
00000111111111l10000
00000111111111100000
00000111111111000000
0000001111bb11000000
000t0e01111bbbs10000
00000000000ssss11r00
000l0000000011111l00
00000000000001111100
00000000000000011100
000000000000000d1000
00000000000000000000
00000000000000000000
