00000000000000000000
00000000000000000000
00000000000000000000
000001s0000000000000
000011n0000l00000000
0000bbb0000000000000
00001110e00000000000
00001110000000000000
00001110000000000000
00001110l00000000000
00000111000000000000
00000111000000000000
000001p1000bbbb00000
0000001100000sbd1000
0000001110001sb10000
0000ss0111111sslr000
0000n110111110sss000
00000l000b100001n100
000000e00t0r0001a000
00000000000000000000
