00000000000000000000
00000000000000000000
00000000000000000000
00000000000000000000
0011110l000000000000
00000100000000000000
00000100000000000000
00000110000011100000
0000111111001s100000
00000111011111100000
000l01p0000b1l100000
00000110000b11100000
00000110000bbb000000
00000010000000000000
0001111111111111d000
00011100000100000000
00001100000100000000
00000sssssss00000000
000r000000000000b000
00r00000l00000000000
