00000000000000000000
00000000000000000000
00000000000000000000
00111000000000000000
00lp100r000000000000
00111000000000000000
00111000000000000000
00011111s00000000r00
00011000000000000000
00011000000000000000
00s11000000000000000
0bs111b11ls100000000
00s011b111s110000000
0000010l000011d00l00
00000100000000000000
0r000100000000000000
00000000000000000000
00000000000000000000
00000000000000000000
00000000000000000000
