00000000000000000000
00e00000000000000000
00000000000000000000
00111b00000000000000
001d1b1s1111s0000000
00b11b1s111100000000
00011b1s111100000000
0000000l011100000000
0sss000001n100000000
0000000t011100000000
00000000011100000000
000000000n1100000000
00000000011000000000
000r000l0110000t0000
00111111111000000000
001p1111111100000000
00111111111100000000
00000000000000000000
000000000000000e0000
00000000000000000000
