00000000000000000000
00000000000000000000
00000000000000000000
00000000000010000000
00000000001110000000
000000e0lb1d1b000000
0000000bbbbbbbs0b0t0
0000000ss11111s10000
00000111sssssss00000
00000011111111100000
00000011111111000000
000000011100000000e0
000000l0111000000000
00000001111s00000000
0000001p100000000000
00000001100000000000
00000000000000000000
00000000000000000000
0000000e00000000t000
00000000000000000000
