00000000000000000000
00000000000000000000
00000000000000000000
00000000110000000000
0000e001dbl0000000t0
00000000sbbb00000000
00000000111000000000
0000000001111110e000
0000t000111110l00000
0000000011101sss0000
00000000011110000000
00000000001111000000
0000000000tp11000000
00000000001101000000
00000000000111000000
0000000000l111110000
00000000000001000000
0000000b000000000000
000000000000000e00r0
00000000000000000000
