00000000000000000000
00000000000000000000
00000000000000000000
00000000000000000000
00000000000000000000
00000000000000000000
00000000000000000000
00011111111111100000
00011111111111100000
00011111l11111100000
00011100000011100000
00011100000011100000
00011100000011100000
0L011100000011100000
0001p1000000l1d00000
00011100000011100000
00000000000000000000
00000000000000000000
00000000000000000000
00000000000000000000
