00000000000000000000
00000000000000000000
00000000000000000000
00000000000000000000
00000000000000000000
000s1000000000000000
lt00111000l000000000
000111100sss00000000
000111111b0000000000
00011111bbbb11100000
00011100000001100000
000sssl0000011100000
00010s0000t01p100000
0000ds00000011100000
00001100000001100000
0r00100000000bb00000
0000000000000l100000
0000b00000t001100000
00000000000000000000
00000000000000000000
