00000000000000000000
00000000000000000000
00000000000000000000
00000000000000000000
00000000000000000000
00000000000000000000
00011111110000000000
00011111d10000000000
00011111110000000000
000rrr00000000000000
00111100r00e00000000
001rrr00000000000000
00111100l00000000000
00011111111100000000
00011111111100000000
0001p100e00000000000
00011100000000000000
00000000000000000000
00000000000000000000
00000000000000000000
