00000000000000000000
00000000000000000000
00000000000000000000
00000000000000000000
00000000000000000000
0000000001b000000r00
00000000010l00000000
000000e0010s01p00000
00000000010101100000
000000t0111111000000
000r0000111111000000
00000000100000l00e00
000t000lss0000000000
00000000100000000000
00000000bb0000000000
000000d1100000000000
000000000l0000000000
00000000000000000000
00000000000000000000
00000000000000000000
