00000000000000000000
0000000000000000e000
0000000000b000000000
00000s100000000n1000
00000111111000001000
00sss11111e01000n100
000a000b111111100000
000000lb111111111000
0000001b11p111110000
00000011111111110000
00bb01101110l0000000
00ssn100111000000000
000ln000111000000000
0000n001111000000000
000000011100e0000000
00000011110000000000
00000011110000000000
00r000111100l0000000
00000000d00000000000
00000000000000000000
