00000000000000000000
00000000000000000000
00000000000000000000
00000000000000000000
00000000000000l00000
0000000000000bbb0000
00000000000000000000
00000000111000000000
000011111b11s11d0000
000111111b11s1110000
00000100000000000000
0001111ssss111111110
0001111sbls111s11p10
0001111ssss111111110
00000011111100000000
00000000000000000L00
00000000000000000000
00000000000000000000
00000000000000000000
00000000000000000000
