00000000000000000000
000sb000000000000000
0e0sbt00000000000000
00lsb000000000000000
00d10000000000000000
00011000e00p1000l000
00011100000100000000
00n10111000110000000
0001111100bbbb000000
00011ln1s00111000000
00011111s1111100r0e0
01n01111s01l11000000
00011111s0111101n000
00011111000111000000
00011110000111001n00
0011110000000b000000
000l000000000bb11s00
00t0r00000000000b000
0000000000000000l000
00000000000000000000
