00000000000000000000
00000000000000000000
00000000000000000000
00000000000000000000
00000000000000000000
00000000000000000000
00011111110000000000
00011111d10000000000
00011111110000000000
000bbb00000000000000
00111100b00r00000000
0l1bbb00000000000000
00111100l00000000000
00011111111100000000
00011111111100000000
0001p100r00000000000
00011100000000000000
00000000000000000000
00000000000000000000
00000000000000000000
