00000000000000000000
00000000000000000000
00000000t00l00000000
000001b1000000000000
000011b1111000000000
000111001d1s10000000
00011000011s11000000
0r11100000001100t000
00111100s00011100000
0001s10ls00011100000
00111100s00001100000
0000bbbbb00l01111000
00000111000111100000
00000011111p11000000
00000001111110000000
00000000011000000000
0t00l000111000000000
00001111111000000000
0000b111110000000000
00000000000000000000
