00000000000000000000
00000000000000000000
00000000000000000000
00000000000000000000
00000000000000000000
00000000000000000000
00011111111001110000
00011111111001d10000
00011111111001110000
00011100111001110000
0001L100111001L10000
00011100111001110000
00011100111111110000
0001p100111111110000
00011100111111110000
00000000000000000000
00000000000000000000
00000000000000000000
00000000000000000000
00000000000000000000
