00000000000000000000
00000000000000000000
00000000000000000000
00000000000000000000
0b0r0000000l00000000
000000l0001110000000
00011111111p10000000
00011111111110000000
00000bbb00001111s000
0111111110ssss000000
001111111100l0000000
00000sss000000000000
00001111111000000000
0000011111d100000000
0000000000l00r000000
00000000000000000000
00000000000000000000
00000000000000000000
00000000000000000000
00000000000000000000
