00000000000000000000
00000000000000000000
00000b0000000l000000
0000001001000t000000
000l0t11b100bbb00000
00000111b11100000000
00001110011d00000000
00001100000000000000
0000ss00000000000000
0000l100000000000000
0000sss0000000000000
0000111111111s000000
0e00111111p100b00000
00000111111100bl0r00
0r000001011100b00000
00000000000000000000
000000l000000t000e00
00000000000000000000
00000000000000000000
00000000000000000000
