00000000000000000000
00000000000000000000
00000000000001111000
00000000000011111100
00000000000011p1r100
00l00000000011111000
00011000000011111100
00sssss000000111t1l0
00sbbbs11110s1101000
00sbdbs1111ls1000000
00sbbbs1111b11000000
00sssss1111b1000l000
00t11111111000000000
000bbbsssss000000000
00011111111000000000
00l00111s100b0000000
00000000000000000000
00000000000000000000
00000000000000000000
00000000000000000000
