00000000000000000000
00000000000000000000
0000000000000e000000
00001110000000000000
00011111111100000000
001110000b1111100000
0t111000lb001p100000
000111000b0001100000
0001b000000000000000
0e01b00s111000000000
0001bbbs1d1000000000
0001100s111000000000
000l1100110bbb000000
000011100000l0000000
00001101000000000000
0000011111111s000000
000001110sss11000000
0000000000b11000e000
00000000000000000000
000t000000000000r000
