00000000000000000000
00000000000000000000
00000000000000000000
00000000000000000000
00000000000000000000
0p11l00000000l000000
0111100001d100000000
000n11100sss0ns00000
00001n100bbb0ss00000
0000011111110e000000
00000011111100000000
00000001111100000000
00e00000l11100000000
00000000011000000000
00r0000000100b111000
0000000001111bb1s000
00000000011111b11000
001n000000000abl0000
00b00000000000000000
00000000000000000000
