00000000000000000000
00000000000000000000
0000t000be0000000000
00000000000000000000
0000a000000000000000
000000000l0001000000
0000100010011ssbb000
000b111011111snnd100
001b111111111ssbb000
00pb1111111111100000
000b11111000100sss00
0001000000l1100sl000
000000000001000s0000
00l000000a0s0000r000
00000000000000000000
000001n1000000000000
000000e0000000000000
00000000000000000000
00000000000000000000
00000000000000000000
