00000000000000000000
00000000000000000000
00000000000000000000
00000000000000000000
00000000000000000000
00000000000000000000
000000000e00t000l000
00000000000000000000
0b00e00001110000t000
000000001l1b1b100000
00000000111b1b110000
00000011111b11111000
00000001111b1111p000
0000011111101n000000
0l000d01111100001n00
0000000000011000l000
000000000000n1000000
00000000000000000000
000000000000r00e0000
0000000000000000000e
