00000000000000000000
00000000000000000000
00000000000000000000
00000000000000000000
00000000000000000000
00000111111110000000
0000001d1l1100000000
00000011111100000000
0000001p11l100000000
00000001111100000000
00000011110000000000
00000001l10000000000
00000000110000000000
00000000000000000000
00000000000000000000
00000000000000000000
00000000000000000000
00000000000000000000
00000000000000000000
00000000000000000000