00000000000000000000
00000000000000000000
00l00000000000000000
00000110000000000000
00001d10000000000000
00000111000000000000
00000011100000000000
000000sss00000000000
0000001n100000000000
0000l011110000000000
00t000011n0000000000
00000000111l0000e000
000000000n1100000000
00000s110bbbb0000000
00000001111110000000
0000000e0001p1000000
00000000000111000000
00000000000000000000
0000r00000000000t00b
00000000000000000000
