00000000000000000000
0000000000r000e00000
0000000d000000000000
00000001000000000000
000lb0sss00000000000
00000001000000000t0l
000n100111111000s000
00000000000010001000
00000000000011111000
00000000000010000000
0000000000lbbb000000
00000000000010000000
01111111111010000000
00011100001110000000
00000000001000000e00
00p11111111000000000
000000l0000000r00000
00000000000000000000
00e0000000000t000000
00000000000000000000
