00000000000000000000
00000000000000000000
00000000000000000000
00000000000000000000
00000000000000000000
00111111111111110000
00ep1111111111110000
00111111111111110000
00l11111100011110000
00111111000001110000
0011111100000rrr0000
0011111e00l001110000
00111111011101110l00
00011111011101110000
0000111101110rrr0000
00000111e1r101110000
00000011011101d10000
00000001011101110000
00000000000000000000
00000000000000000000
