00000000000000000000
00000000000000000000
00000000000000000000
00000000000000000000
00000000000000000000
00000000000000000000
00000000000000000000
00000000000000000000
00000b000t000l000000
00000000000000000000
0000000111b111000000
00000001p1b1d1000000
0000000111b111000000
00000000000000000000
00000000000000000000
000000l0t00000000000
00000000000000000000
00000000000000000000
00000000000000000000
00000000000000000000
