00000000000000000000
00000000000000000000
00000000000000000000
00000000000000000000
00000000111000000000
000000001d1000000000
00000000111000000000
000000001l1000000000
00000000111000000000
00000000111000000000
00000000111000000000
00000000111000000000
000000001pL000000000
00000000111000000000
00000000000000000000
00000000000000000000
00000000000000000000
00000000000000000000
00000000000000000000
00000000000000000000
