00000000lr0000000000
0000000011l0000b0000
000000001p000t0b0r00
000000001100000b0000
00000001110000000000
000001111bnnb1110000
000001110bnnb1111000
000001e1001100000000
00000111001s00000000
0000001n00l10e000000
000011b1000000000000
00000111100000000000
00000ssss00000000000
00000bbbb00000000000
00000011000000000000
0000001d000000000000
0000l000000000000t00
00000000000000000000
00000000000000000000
00000000000000000000
