00000000000000000000
00000000000000000000
00000000000000000000
00000000000000000000
000sl000000000000000
000sn00e0s0000000000
0001000001bl00000000
0000000101bn10000000
0000000101bbb0000000
0000d001010000000000
00sss111111000000000
0asls111111100000000
0r0001111110e0l00000
00000011111000000000
00000000001100000000
00000000000100000000
000000000001p0000000
0b000000l00000000000
00000000000000000000
0000t000e00000t00000
