00000000000000000000
00000000000000000000
0000000000s000000000
00000000b0s0a0000000
0000000000s000000000
00000a00l00000000000
00000000000000000000
00000000000000000000
0000111111b111100000
00001p11s1b1n11l0000
0000010000b01n100000
00000000000011100000
0000000000001n1t0000
00000000000011100000
00000l00000001100000
0000000000000111s1d0
000000s00b000111s110
00e000s00b00a0000l0e
000000s00b00l00r0000
00000000000000000000
