00000000000000000000
010e00000l0000000000
01111111111110000000
001p1111111110000000
00111111111110000000
0l1111111r1s100t0000
00111111111110000000
00111111111110000000
0essssss11111l000000
nns01111001110000000
00s111100000000n1000
0ts111100111100r0000
00s1bbb0011d10000000
0011blbbb11110000000
0011bbb00111100l0000
0000000b000000000000
0000l00e000000000000
00000000000000000000
00000000000000000000
00000000000000000000
