00000000000000000000
00000000000000000000
00000000000000000000
00000000000000000000
00000000000000000000
00000000000r0000l000
00011111111111000000
000111111111d1000000
00011111111111000000
00011111111111000000
00011111111111000000
00011111111111000000
0001111111l111000000
00011111111111000000
0001p111111111000000
0001111111r111000000
00000000000000000000
00000000000000000000
0000l000000000000000
00000000000000000000
