00000rl0001100000000
00000000001000l00000
000e00l0011111010000
000000001101111s1000
0000000110b11s110000
0000011111bn1s110000
00000111p11e1s100000
00001ss1111b01000000
0001111sss1b00000000
000r1111110000t00000
0011111111s000000000
0a01111111sl00000000
00000110n0s000000000
00000d0nl00000000000
0000000sss0000000000
00000001n10000000000
00000000000000000000
00000000000000000000
00000000a00000000000
00000000000000000000
