00000000000000000000
00000000000000000000
000s0000000000000000
01111111s11111100000
00000011s11d1l000000
00000111s11100000000
00000111000000000000
000l0101000000000000
00000ss1000b00e00000
00000bbb000000000000
00000111000000000000
000001110l0000000000
000e01p10t0000000000
00000111000000000000
00000010000000000000
00000000000000000000
00000000000000000000
0t00000000000r000000
00000000000000000000
00000000000000000000
