00000000000000000000
000000000b0001b1s100
0000e001111111b1s1d0
00000000bbb11b11s000
00000011n1n11b1sl110
00000110111s11bsn000
00001011111ssnb00000
00011s11111100000000
0000r11111100e000000
0001111111bbl0000000
000011p100bsss000000
00000010000000000000
000000el000000000000
0000000000000t000000
00000000000000000000
000000t000000000r000
000000000000a0000000
00000000000000000000
00000000000000000000
00000000000000000000
