00000000000000000000
00000000000000000000
00000000000000000000
00000000000000000000
00000000000000000000
00011000000000000000
001p1110l0e00t0l0000
00011110000000000000
0000111011100b000000
0t00111111111111s000
000011111111bb110000
0lb011111sbbbsss0000
000011111sbl000s0000
000011111110nnb1bnn0
00001111bbbea00d00a0
000011111e0000000000
00001100000000000000
00000000000000000000
00000000000000000000
00000000000000000000
