00000000000000000000
00000000000000000000
00000000000000000000
00000000000000000000
00000000000000000000
00000001110000000000
00000001d10000000000
00000001110000000000
0000000l110000000000
00000001110000000000
0000000rrr0000000000
00000001110000000000
0000r001110000000000
0000000111L000000000
00000001p10000000000
00000001110000000000
00000000000000000000
00000000000000000000
00000000000000000000
00000000000000000000
