00000000000000000000
00000000000000000000
00000000001100000000
00000s00001100000000
000e0s0t01p110000000
00000s00011110000000
00000000011110000000
0000000l011100000000
000n100011110s000000
0000000111111sl00r00
0000000111111s0001n0
00000001111111s00e00
000t000111bbb1100000
00000000ssssb1100000
0000000011b1sss00000
0000000000nssbb00000
00000000001b1d100000
00000000001b11100000
0000000000a00l000000
00000000000000000000
