00000000000000000000
00001110000000000000
00001d11000000000000
0000bbbb000000000000
00l011110t0e00000000
0000sss0000000000000
00001000000000000000
0000100000l00000000r
00001000100000000000
0000100010000s000000
0l0011111111n1000e0t
00001000000000000000
00001000000000000000
00001111111111100000
0000111l11111p10l000
00001111111111100000
00000000000000000000
0t0e0000000t00000000
11n00000000000000000
0b000000000000000000
